11111111111111111111
1C01111000C111000001
10001100000110000E01
10001110000100000001
10000000000C00000001
10000011000001111111
10P01111100001111111
1000111111C011111111
11111111111111111111