11111111111111111111
1P101C00000000000001
10001111111110011101
111000000000000001C1
11111111111111111101
1000000000C000000001
1C000111111100011111
11100000E0110000C001
11111111111111111111