11111111111111111111
1P000000000000C00001
11111111111111111101
110000000C0000000101
1C011111111111C101C1
1101CE01110C11110101
11010000000000000101
11011111111111111101
1C00000000C000000001
11111111111111111111
